{
	"tileset" : "chemin.png",
	"terrain" : [
		[5, 6, 6, 6, 6, 6, 6, 6, 6,  6,  6,  6,  6,  6,  7],
		[9, 10, 10, 10, 10, 10, 10, 10, 10,  10,  10,  10,  10,  10,  11],
		[9, 10, 10, 14, 14, 14, 10, 10, 10, 14, 14, 14,  10,  10, 11],
		[9, 10, 11, 2, 2, 2, 9, 10, 11,  2,  2,  2,  9,  10,  11],
		[9, 10, 11, 2, 2, 2, 9, 10, 11,  2,  2,  2,  9,  10,  11],
		[9, 10, 11, 2, 2, 1, 9, 10, 11,  1,  2,  2,  9,  10,  11],
		[9, 10, 10,  6,  6,  6, 10, 10,  8,  6,  6,  6,  10,  10,  11],
		[9, 10, 10, 10, 10, 10, 10, 10, 10, 10, 10, 10, 10, 10, 11],
		[9, 10, 10, 10, 14, 14, 12, 10, 12, 14, 14, 14, 10, 10, 11],
		[9, 10, 11, 2, 2, 1, 9, 10, 11,  1,  2,  2,  9,  10,  11],
		[9, 10, 11, 2, 2, 2, 9, 10, 11,  2,  2,  2,  9,  10,  11],
		[9, 10, 11, 2, 2, 2, 9, 10, 11,  2,  2,  2,  9,  10,  11],
		[9, 10, 10, 6,  6,  6, 10, 10, 10,  6,  6,  6,  10,  10,  11],
		[9, 10, 10,  10,  10,  10,  10, 10, 10,  10,  10,  10,  10,  10,  11],
		[9, 14, 14, 14, 14, 14, 14, 14, 14,  14, 14, 14, 14, 14, 14]
	]
}
